R 600 400

NO ./textures/wall1.png
SO ./textures/wall2.png

WE ./textures/hitler.png
EA ./textures/wall3.png

S ./path_to_the_sprite_texture

F 220,100,0

C 225,30,0

1111111111111111111111111111111
10000000000000000000000000001E1
1000000000000000000000000000001
1000000000000000000000000000001
1111111111111111111111111111111
