R 1920 1080

NO ./textures/wood.png
SO ./textures/bluestone.png

WE ./textures/mossy.png
EA ./textures/redbrick.png

S ./textures/taylor3.png

F 178,178,178

C 101,216,255

1111111111111111111111111111111
1111111110000000001111111111111
10000000000000000000000000S0001
1000000000000000000000000000001
1002000000100111111000000000001
1000000010100000001000000000001
1000001000100000000000000000001
1000000000100020000000000000001
1000000000100000001000000000001
1001100101111011111000000000001
1000000000000000000000000000001
1000200000000000000000000000001
1000000000000000000000000020001
1111111110000000000000000000001
1111111110011110111111000111111
1111111110000000111000000000111
1111111110002000000000200001111
1111111110000000111000000000011
1111111111111111111111111111111
