R 800 600


S ./textures/taylor3.png


F ./textures/purplestone.png


NO ./textures/wood.png
SO ./textures/bluestone.png


WE ./textures/mossy.png
EA ./textures/redbrick.png
C 255,255,256

1111111111111111111111111111111
1111111110000000001111111111111
10000020002220000020020000S0001
1000000000000000000000000000001
1002000000100111111000000202001
1000000010100000001000000000001
1020001000100002000002000200001
1020020000100020000000002222001
1000020000100000201000022222201
1001100101111011111000222222221
1000000000200000000000022222201
1000200000000000200000002222001
1000000022202000020200000222001
1111111110000000000000000020001
1111111110011110111111000111111
1111111110000000111000000000111
1111111110002000000000200001111
1111111110000000111002200000211
1111111111111111111111111111111
