R 1920 1080

NO ./textures/barack2.png
SO ./textures/madeline2.png

WE ./textures/dog2.png
EA ./textures/taylor2.png

S ./path_to_the_sprite_texture

F 220,100,0

C 225,30,0

1111111111111111111111111111111
1000000000000000000000000000001
10000000000000000000000000S0001
1000000000000000000000000000001
1000000000100111111000000000001
1000000010100000001000000000001
1000001000100000000000000000001
1000000000100000000000000000001
1000000000100000001000000000001
1001100101111011111000000000001
1000000000000000000000000000001
1000000000000000000000000000001
1000000000000000000000000000001
1000000000000000000000000000001
1000000000011111111111111111111
1000000000000000000000000000001
1000000000000000000000000000001
1000000000000000000000000000001
1111111111111111111111111111111
