R 800 600


S ./textures/barack2.png


NO ./textures/hitler.png
SO ./textures/hitler.png


WE ./textures/hitler.png
EA ./textures/hitler.png
F ./textures/hitler.png
C 127,40,150

11111111111111111111111111111
010011111000000000111111110111
10000020002220000020020000S001
100000000000000000000000000001
100200000010011111100000020201
1000000010100000001000000000001
102000100010000200000200020011
1020020000100020000000002220001
1000020000100000201000022222201
1001100101111011111000222222221
1000000000200000000000022222201
1000200000000000200000002222001
1000000022202000020200000222001
1111111110000000000000000020001
1111111110011110111111000111111
1111111110000000111000000000111
1111111110002000000000200001111
1111111110000000111002200000211
1111111111111111111111111111111
