          R     1920 1080


S ./textures/barack2.png


     NO     ./textures/hitler.png
SO    ./textures/test.png


    WE ./textures/hitler.png
EA ./textures/rickandmorty.png
F ./textures/tinyface.png
      C  ./textures/awesomeface.png

22111111111111111111111111111
211011111000000000111111110111
111110200022200000200200000001
101000000000000000000000000001
111200000010011111100000020201
100000000101000000010000000111
1020001000100002000002000200111
1020020000100020000000002220001
1000020000100000021000022222201
1111111111111111011111111111111
1000000000200000000000022222201
1000200000000000200000002222001
1000000010012000020200000222001       
1111111110010000000000000020001
0000000110011110111111000111111
0000000010000000111000000000111
0000000010E00000000000201001111
0000000010000000111002201000211
0000000011111111111111111111111
1
