R 1024 720

S ./textures/taylor2.png

NO ./textures/hitler.png
SO ./textures/test.png
WE ./textures/hitler.png
EA ./textures/rickandmorty.png

F ./textures/tinyface.png
C ./textures/clouds.png

00111111111111111111111111111
011011111000000000111111110111
111110000000000000000000000001
101000000000000000000000000001
111000000010011111100000000001
100000000101000000010000000111
1000001000100000000000000200111
1000020000100000000000000000001
1000000000100000001000000000001
1000000000000000000000000000111
1000000000000000000000020002001
1000000000000000000000000000001
1000000010010000000000000020001       
1111111110010000000000000000001
0000000110011110111111000111111
0000000010000000111000000000111
0000000010N00000000020001001111
0000000010000000111000001000011
0000000011111111111111111111111
1
