R 1000 680


S ./textures/barack2.png


NO ./textures/hitler.png
SO ./textures/hitler.png


WE ./textures/hitler.png
EA ./textures/hitler.png
F ./textures/hitler.png
C 127,40,150

11111111111111111111111111111
110011111000000000111111110111
101110200022200000200200000001
101000000000000000000000000001
111200000010011111100000020201
10000000010100000001000000011
102000100010000200000200020011
1020020000100020000000002220001
1000020000100000201000022222201
1111111111111111011111111111111
1000000000200000000000022222201
1000200000000000200000002222001
1000000022202000020200000222001
1111111100000000000000000020001
0000000010011110111111000111111
0000000010000000111000000000111
0000000010E02000000000201001111
0000000010000000111002201000211
0000000011111111111111111111111
