R 1000 600

NO ./textures/wood.png
SO ./textures/bluestone.png

WE ./textures/mossy.png
EA ./textures/redbrick.png

S ./textures/taylor3.png


F ./textures/purplestone.png
C ./textures/purplestone.png

111111111111111111111111
100000000000000000000001
100000000000000000000001
100000000000000000000001
100000111110000101010001
100000100010000000000001
100000100010000100010001
100000100010000000000001
100000110110000101010001
100000000000000000000001
100000000000000000000001
100000200000000000000001
100000000000000000000001
100000000000000000000001
100000000000000020000001
100000000000000000000001
111111111000000000000001
110100001000000000000001
110000101000000000000011
110100001000000000000001
110111111000000N00000001
110000000000000000000001
111111111000000000000011
111111111111111111111111
