R 1920 1080

NO ./textures/wall1.png
SO ./textures/bluestone.png

WE ./textures/mossy.png
EA ./textures/redbrick.png

S ./textures/taylor3.png


C ./textures/tinyface.png
F ./textures/nice.png

111111111111111
1000000000000011
10000020000000N1
1000000000000011
111111111111111
