R 500 500

NO ./textures/wall1.png
SO ./textures/bluestone.png

WE ./textures/mossy.png
EA ./textures/redbrick.png

S ./textures/barack2.png


C 101,216,1
F 178,178,178

1111111111111111
1000000000000001
10000020000W0001
1000000000000001
1111111111111111
