NO ./textures/wall_north.png
R 600 1080
SO ./textures/test.png
WE ./textures/awesomeface.png
EA ./textures/mossy.png
S ./textures/barack2.png
F ./textures/nice3.png
C ./textures/nice.png
11111111111111111111111111111
10000000001100000000000000001
10110000011100000020000010001
10010000000000000000000010001
10110000011100000000000010001
10000000001100000111011111111
1111011101111101110001
11110111011111011101011111111
11000000010101011100000010001
10000000000000001100000010001
10000020000000001101010010001
110000N0110101011111011110001
11110111111101011111011110001
11111111111111111111111111111
