R 1920 1080
NO textures/wall_north.png
SO textures/wall_south.png
WE textures/wall_west.png
EA textures/wall_east.png
S textures/sprite.png
F 50,0,0
C -1,255,255


1 1 1 1 1 1 1 1 1 1 1 1 1 1
1 0 2 0 0 2 0 0 0 2 0 0 0 1
1 0 0 0 0 0 0 0 0 0 0 0 0 1
1 0 0 0 0 0 N 0 0 0 0 0 0 1
1 0 2 0 0 2 0 0 0 2 0 0 0 1
1 1 1 1 1 1 1 1 1 1 1 1 1 1


